BBBB---B---BBBB
BXB---------BXB
BB---B---B---BB
B---BBBBBBB---B
B--BBBBBBBBB--B
B---BBBBBBB---B
B--BBBXXXBBB--B
BB---BBBBB---BB
BBB--BBBBB--BBB
BBBB---B---BBBB
BB-BB-----BB-BB
BX-BBB---BBB-XB
B--BBBBBBBBB--B
