-BBBB-----XBX-X
-XBXBX---XBB-P-
P-BBB-----XBXBX
BXBXBX---XBBBBB
BBBBB-----XBXBX
BXBXBX----BBBBB
X-X-X-----X-X-X
BBBBB----XBXBXB
XBXBX-----BBBBB
BBBBBX---XBXBXB
X-XBX-----BBBB-
-PBBBX---XBXBX-
X-XBX-----BBB-P
