%%%%%%%%%%%%%%%%%%%%%%%%%%%%%%%%%%%%%
%                                  P%
% % % % % % % % % % % % % % % % % % %  
%                        .       b  %
% % % % % % % % % % % % % % % % % % %
%                            .      %
% % % % % % % % % % % % % % % % % % %
%                                   % 
% % % % % % % % % % % % % % % % % % %
%                                   %
% % % % % % % % % % % % % % % % % % %
%                                   %
% % % % % % % % % % % % % % % % % % %
%                b                  % 
% % % % % % % % % % % % % % % % % % %
%b                                  %
%%%%%%%%%%%%%%%%%%%%%%%%%%%%%%%%%%%%%%