%%%%%%%%%%%%%%%%%%%%
% S              S %
%      b A         %
%   b  P  b        %
%S  b  b  b        %
%       A        S %
