%%%%%%%%%%%%%%%%%%%%
% S              S %
%     B  A         %
%    B B           %
%S  b Pb  b        %
%       A        S %
%%%%%%%%%%%%%%%%%%%%
