%%%%%%%%%%%%%%%%%%%%
%o   %        %    %
% %% % %%%%%% % %% %
% %              % %
% % %% %%  %% %% % %
%      %G  G%      %
% % %% %%%%%% %% % %
% %    B O       % %
% %% % %%%%%% % %% %
%    %   P    %   o%
%%%%%%%%%%%%%%%%%%%%
