%%%%%%%%%%%%%%%%%%%%
%o...%........%....%
%.%%.%.%%%%%%.%.%%.%
%.%..............%.%
%.%.%%.%%  %%.%%.%.%
%......%G  G%......%
%.%.%%.%%%%%%.%%.%.%
%.%B....bOb......%.%
%.%%.%.%%%%%%.%.%%.%
%....%   P   B%...o%
%%%%%%%%%%%%%%%%%%%%
