%%%%%%%%%%%%%%%%%%%%%%%%
%P  B              B  2%
% % % %%% % % B %  % %%%
% % %     B     %  %   %
% % % B B % % B %  % B %
%   %     %B%B     %   %
% % % % %%% %%% %  % % %
%BBB%    B B B     %BBB%
% % % % %%% %%% %  % % %
%   %    B%B%      %   %
% B % % B % % B B  % % %
%   % %     B      % % %
%%% % % B % % %%%  % % %
%3  B              B  1%
%%%%%%%%%%%%%%%%%%%%%%%%