%%%%%%%%%%%%%%%%%
%B BBB 3 B BBB  %
%B% %B% %B% %B% %
%BBB BBBBBBB BBB%
%B% % % %B% % % %
%BBB B   BBB B  %
%B% % % %B% % % %
% BBBBBBB BBBBBB%
% %B%B% % %B% % %
%  BB   BBBB 2  %
%BB%%B%BBB%B% %B%
%B BBB  BB BBBBB%
%B% %B% %B% %B% %
%BBB BBBBBBB BBB%
%B% % %B%B% % % %
%B 1 BBBBB BBB  %
%B% % %B%B% % % %
% B BBBBB BBBBBB%
% % %B% % %B%B% %
%  BBB     BB  4%
%%%%%%%%%%%%%%%%%
