%%%%%%%%%%%
%BBBBBBBBB%
%B%B%B%B%B%
%BBBBBBBBB%
%B%B%B%B%B%
%BBBBBBBBB%
%B%B% %B%B%
%BBB P BBB%
%B%B% %B%B%
%BBBBBBBBB%
%%%%%%%%%%%
