%%%%%%%%%%%
%  BBBBBBB%
% %B%B%B%B%
%BBBBBBBBB%
%B%B%B%B%B%
%BB  2BBBB%
%B%B% %B%B%
%BBBBBBBBB%
%B%B%B%B% %
%BBBBBBB 1%
%%%%%%%%%%%
