%%%%%%%%%%%
%3 BBBBB 2%
% %B%B%B% %
%BBBBBBBBB%
%B%B%B%B%B%
%BBBBBBBBB%
%B%B%B%B%B%
%BBBBBBBBB%
% %B%B%B% %
%P BBBBB 1%
%%%%%%%%%%%
