%%%%%%%%%%%
%2 BBBBBBB%
% %B%B%B%B%
%BBBBBBBBB%
%B%B%B%B%B%
%BBBBBBBBB%
%B%B%B%B%B%
%BBBBBBBBB%
%B%B%B%B% %
%BBBBBBB 1%
%%%%%%%%%%%
