%%%%%%%%%%
%BB BBB 2%
%BB% %B% %
%BBBB BBB%
%BB% % % %
%BB 1 B  %
%BB% % % %
%  BBBBBB%
%  %B%B% %
%P  BB  3%
%%%%%%%%%%
