%%%%%%%%%%
%BB BBB P%
%BB% %B% %
%BBBB BBB%
%BB% % % %
%BB   B  %
%BB% % % %
%  BBBBBB%
%  %B%B% %
%P  BB   %
%%%%%%%%%%
