%%%%%%%%%%%%%
%           %
%   1       %
%        3  %
%           %
%      2    %
%           %
%           %
%  PS   4   %
%           %
%%%%%%%%%%%%%
