%%%%%%%%%
%B BBB 2%
%B% %B% %
%BBB BBB%
%B% % % %
%B 1 B B%
%B% % % %
% BBBB B%
% %B%B% %
%P  B  3%
%%%%%%%%%
