%%%%%%%%%%%%%%%%%
%B BBB 3 B BBB 2%
%B% %B% %B% %B% %
%BBB BBBBBBB BBB%
%B% % % %B% % % %
%BBB B 3 BBB B  %
%B% % % %B% % % %
% BBBBBBB BBBBBB%
% %B%B% % %B%B% %
%2 BB   B1 BB  4%
%BB%%B%BBB%B%%BB%
%B BBB 4BB BBB  %
%B% %B% %B% %B% %
%BBB BBBBBBB BBB%
%B% % %B%B% % % %
%B 1 BBBBB BBB  %
%B% % %B%B% % % %
% B3BBBBB BBBBBB%
% % %B% % %B%B% %
%P       P BB  4%
%%%%%%%%%%%%%%%%%
