%%%%%%%%%
%B BBB 2%
%B% %B% %
%BBB BBB%
%B% % % %
%B 1 B  %
%B% % % %
% BBBBBB%
% %B%B% %
%P BB  3%
%%%%%%%%%
